17
12
xxxxxxxxxxxxxxxxx
x       t       x
x               x
x      ccc      x
x      ccc      x
x      ccc      x
x      ccc      x
x      ccc      x
x      ccc      x
x      ccc      x
x      ccc      x
xxxxxxxcccxxxxxxx
7, 12, map2.txt, 4, 3
8, 12, map2.txt, 4, 3
9, 12, map2.txt, 4, 3