17
12
xxxxxxxxxxxxxxxxx
x       t       x
x               x
x      ccc      x
x      ccc      x
x      ccc      x
x      ccc      x
x      ccc      x
x      ccc      x
x      ccc      x
x      ccc      x
xxxxxxxcccxxxxxxx
7 11 map2.txt 6 4
8 11 map2.txt 6 4
9 11 map2.txt 6 4